2 2 2 2 2 2 2 2 2 2 2 2 2 2 2 2
2 3 3 3 0 0 8 8 8 8 8 0 0 0 0 2
2 3 11 3 0 0 8 8 8 8 8 0 0 11 0 2
2 3 11 3 0 0 0 0 0 0 0 0 0 11 0 2
2 0 11 0 0 0 0 0 0 0 0 0 0 11 0 2
2 0 11 4 4 4 4 4 4 4 4 4 4 11 0 2
2 0 2 4 2 2 2 2 2 2 2 2 4 2 0 2
2 0 2 4 2 2 2 2 2 2 2 2 4 2 0 2
2 0 2 4 2 2 2 2 2 2 2 2 4 2 0 2
2 0 2 4 2 2 2 2 2 2 2 2 4 2 0 2
2 0 11 4 2 2 2 2 2 2 2 2 4 11 0 2
2 0 11 4 4 4 4 4 4 4 4 4 4 11 0 2
2 0 11 0 0 9 0 0 0 0 0 0 0 11 0 2
2 0 11 0 0 0 11 12 13 14 0 0 0 11 0 2
2 0 3 3 0 0 11 81 82 11 0 0 0 0 0 2
2 2 2 2 2 2 2 2 2 2 2 2 2 2 2 2